11111111111111111111111
10000C000000000C00C0C01
10000100011C0C0C0P00001
1E0000001111000001C1001
11111111111111111111111