11111111111
10P0C0000E1
10110100C11
100C0C00101
1111001C001
11111111111