11111111111111111111111111111111111
1E0C0C0C0C0C0C0C0C0C0C0C0C0C0C0C0C1
11101010101010101010101010101010101
10101010101010101010101010101010101
101C0C0C0C0C0C0C0C0C0C0C0C0C0C0C0C1
1C101010101010101010101010101010101
10101010101010101010101010101010101
101C0C0C0C0C0C0C0C0C0C0C0C0C0C0C0C1
1C101010101010101010101010101010101
10101010101010101010101010101010101
101C0C0C0C0C0C0C0C0C0C0C0C0C0C0C0C1
10101010101010101010101010101010101
10101010101010101010101010101010101
1P0C0C0C0C0C0C0C0C0C0C0C0C0C0C0C0C1
11111111111111111111111111111111111